WWWWWWWWWWWWWWWW
WWVV      VVV. W
WWV.W       W  W
WVVVVWWWWWWWWVVW
W .    W       W
W      W   .   W
W      W.      W
W      WWWW    W
W              W
W   WWWW       W
W      W       W
W      W       W
W .   WWW      W
W      W       W
W      .       W
WWWWWWWWWWWWWWWW